20 6
####################
#.......#....#.....#
#............#.....#
#.......#..........#
#.......#....#.....#
####################
